NO textures/greystone.xpm
SO textures/redbrick.xpm
WE textures/purplestone.xpm
F 255,153,51
EA textures/colorstone.xpm
S  textures/green_tree.xpm

R 1920 1080

C 72,61,139

        1111111111111111111111111
111111111000000001000000000000001
        1011000001000000000000001
        1001000001000000000000001
111111111011000000000000000000001
100000000011000000000000000111111
11110000000000000000000000001
11110111111110000000000000001
1100001     10011100000000001
10000011111110001100000000001
10000000000000000000000000001
11000001110101011111000000E0111
11110001 1110101 101000000001
11111111 1111111 111111111111