NO textures/brick.xpm
SO textures/redstone.xpm
WE textures/wood.xpm
F 255,153,51
EA textures/brick.xpm
S  textures/jojo.xpm

R 1920 1080

C 0,0,153




0111111111
10000000011111111 11
10000000000000E01 101
10001000000000011  11
10000000011111111
1020002001
1000020001
1010000201
1111111111



